*..............
.*.......*.....
..*...*..**....
...*...........
.*.............
....*.....**...
....*..**......
....*..*...**..
..*............
..***..*.......
...........**..
...............
...*.*.........
...**..........
.....***......*
